Name	Baccalaureate Institution	Field of Study	Current Institution
Abell, Jared	California Inst of Technology	Chemistry	
Abraham, Leonard G	Cornell U/NY	Engineering - Electrical and Electronic	
Adams, Phillip A	U of California-Berkeley	Life Sciences - Biology	
Allen, Clarence R	Reed College/OR	Chemistry	
Allen, Robert H	U of Connecticut-Storrs	Physics and Astronomy	
Allenson, Douglas R	Oberlin College/OH	Chemistry - Physical	
Anderson, Charles D	N/A	Chemistry - Organic	
Anderson, Sydney	U of Kansas	Life Sciences - Zoology	
Andrews, Charles F	U of California-Berkeley	Chemistry - Physical	
Arends, Charles B	N/A	Chemistry - Physical	
Armitage, Kenneth B	Bethany College/WV	Life Sciences - Zoology	
Arnold, William H	Cornell U/NY	Physics and Astronomy	
Aronov, Saul	Cooper Union/NY	Engineering - Electrical and Electronic	
Aronson, Seymour	Yeshiva U/NY	Chemistry - Physical	
Aspinwall, Dennis M	N/A	Engineering - Civil	
Auerbach, Robert	Berea College/KY	Life Sciences - Zoology	
Aumann, Robert J	CUNY-City College	Mathematical Sciences	
Auster, Simon L	N/A	Life Sciences - Biophysics	
Baily, Walter L	N/A	Mathematical Sciences	
Baker, Donald R	California Inst of Technology	Geosciences - Geology	
Baskir, Emanuel	Columbia U/NY	Physics and Astronomy	
Bass, Robert W	Johns Hopkins U/MD	Mathematical Sciences	
Bastian, James W	Purdue U/IN	Life Sciences - Zoology	
Bate, George L	Princeton U/NJ	Geosciences - Geology	
Battley, Edwin H	Harvard U/MA	Life Sciences - Biology	
Beam, Barbara B	Baker U/KS	Life Sciences - Microbiology	
Beck, Anatole	CUNY-Brooklyn College	Mathematical Sciences	
Becker, Edwin D	N/A	Chemistry - Physical	
Becker, Robert L	U of Missouri-Rolla	Physics and Astronomy - Nuclear	
Beerbower, James R	U of Colorado	Geosciences - Geology	
Belshe, John C	Iowa State U	Geosciences - Geology	
Bennett, Dorothea	Columbia U/NY	Life Sciences - Zoology	
Berdick, Murray	George Washington U/DC	Chemistry	
Berkowitz, Lewis M	N/A	Chemistry - Organic	
Berkowitz, Joseph	New York U	Engineering - Chemical	
Berkowitz, Joan B	N/A	Chemistry - Inorganic	
Berlincourt, Ted G	Case Western Reserve U/OH	Physics and Astronomy	
Bernard, Richard L	Ohio State U	N/A	
Biggs, Robert D	Rice U/TX	Engineering - Chemical	
Bingham, Harry H	N/A	Physics and Astronomy	
Birkmeier, Robert L	N/A	Chemistry - Physical	
Bond, Richard R	Salem-Teikyo U/WV	Life Sciences - Zoology	
Borecky, Gloria W	U of Pittsburgh/PA	Life Sciences - Ecology	
Bowbeer, Arthur C	US Merchant Marine Academy/NY	Chemistry - Analytical	
Bowen, Charles C	Michigan State U	Life Sciences - Biology	
Brace, William F	Massachusetts Inst of Technology	Geosciences - Geology	
Bradley, Sterling G	Southwest Missouri State U	Life Sciences - Biology	
Brooks, Norman H	Harvard U/MA	Engineering - Civil	
Brown, Arthur C	U of Chicago/IL	Physics and Astronomy	
Brown, John L	Williams College/MA	Physics and Astronomy	
Brown, Hugh N	U of Illinois-Urbana-Champaign	Physics and Astronomy	
Browne, Colin L	Lafayette College/PA	Chemistry	
Bryant, Donald L	U of California-Los Angeles	Geosciences - Geology	
Buck, Richard P	California Inst of Technology	Chemistry - Analytical	
Buettnerjanusch, John	U of Chicago/IL	N/A	
Burford, Thomas M	Washington U/MO	Engineering - Electrical and Electronic	
Burkhardt, James L	Massachusetts Inst of Technology	Physics and Astronomy	
Burnett, Bruce B	Lehigh U/PA	Chemistry	
Butzel, Henry M	Williams College/MA	Life Sciences - Zoology	
Callaway, Joseph	College of William & Mary/VA	Physics and Astronomy	
Calsoyas, Chris D	U of California-Berkeley	Physics and Astronomy	
Campbell, Allan M	U of California-Berkeley	Life Sciences - Microbiology	
Capel, Charles E	SUNY-Albany	Mathematical Sciences	
Carlson, John B	Saint Olaf College/MN	Life Sciences - Biology	
Carver, Thomas R	Harvard U/MA	Physics and Astronomy	
Case, Leslie C	N/A	Engineering - Chemical	
Cavin, William P	Wofford College/SC	Chemistry - Organic	
Century, Bernard	U of Chicago/IL	N/A	
Chalfin, David	U of Oklahoma	Life Sciences - Physiology	
Cheetham, Alan H	New Mexico Inst of Mining & Tech	Geosciences - Geology	
Chenoweth, Robert D	Texas A&M U	Engineering - Electrical and Electronic	
Christensen, Earl M	U of Utah	Life Sciences - Botany (including Plant Physiology)	
Clement, Robert A	Massachusetts Inst of Technology	Chemistry	
Clippinger, Everett	U of Chicago/IL	Chemistry	
Cloke, Paul L	Harvard U/MA	Geosciences - Geology	
Coe, Elmon L	Harvard U/MA	N/A	
Cohen, Michael	Cornell U/NY	Physics and Astronomy	
Cohen, Carolyn	Bryn Mawr College/PA	Life Sciences - Biophysics	
Cohn, Naomi K	N/A	Life Sciences - Microbiology	
Cohn, Charles E	U of Chicago/IL	Physics and Astronomy	
Cohn, Victor H	N/A	Life Sciences - Biology	
Coleman, James S	Washington State U	Chemistry - Physical	
Collinson, James A	Oberlin College/OH	Physics and Astronomy	
Connor, Robert L	Washington U/MO	Life Sciences - Zoology	
Cooley, William E	Central Methodist College/MO	Chemistry - Inorganic	
Coram, Beverly N	N/A	Life Sciences - Biology	
Cox, Arthur N	California Inst of Technology	Physics and Astronomy - Astronomy	
Craddock, John C	DePauw U/IN	Geosciences - Geology	
Cronin, James W	Southern Methodist U/TX	Physics and Astronomy	
Crowell, Richard H	Harvard U/MA	Mathematical Sciences	
Cruickshank, Philip A	U of Washington	Chemistry - Organic	
Curl, Rane L	Massachusetts Inst of Technology	Engineering - Chemical	
Curnutte, Basil J	United States Military Academy/NY	Physics and Astronomy	
Currie, Lloyd A	N/A	Chemistry - Physical	
Curtis, Sadie G	N/A	Chemistry - Organic	
Cutkosky, Richard E	Carnegie Mellon U/PA	Physics and Astronomy	
Dalton, John C	U of Virginia-Charlottesville	Life Sciences - Biology	
Danford, Masil B	U of Texas-Austin	Mathematical Sciences - Probability and Statistics	
Darnell, William H	VA Polytech Inst & State U	Engineering - Chemical	
Darrow, Robert A	N/A	Life Sciences - Biology	
Dasmann, Raymond F	U of California-Berkeley	Life Sciences - Zoology	
Davis, Darrell L	Oregon State U	Life Sciences - Physiology	
Davison, John A	U of Wisconsin-Madison	Life Sciences - Zoology	
Davison, Walter F	California Inst of Technology	Physics and Astronomy - Theoretical Physics	
Day, Willard F	U of Virginia-Charlottesville	Psychology	
Defremery, Donald	U of California-Berkeley	N/A	
Demerec, Vera R	Swarthmore College/PA	Life Sciences - Zoology	
Denney, Donald J	U of Pennsylvania	Chemistry	
Deser, Stanley	CUNY-Brooklyn College	Physics and Astronomy	
Dittmer, Donald C	U of Illinois-Urbana-Champaign	Chemistry	
Dixon, Harvey L	N/A	Engineering - Industrial	
Dobrow, Sherry P	N/A	Chemistry - Organic	
Doggett, Wesley O	U of North Carolina-Chapel Hill	Physics and Astronomy	
Donoho, Paul L	N/A	Physics and Astronomy	
Dove, Richard C	Iowa State U	Engineering - Mechanical	
Dowell, Arthur M	Samford U/AL	Chemistry	
Dumke, William P	U of Chicago/IL	Physics and Astronomy	
Dunham, Robert J	U of Oklahoma	Geosciences - Geology	
Eggen, Douglas A	U of Chicago/IL	Life Sciences - Biophysics	
Elspas, Bernard	CUNY-City College	Engineering - Electrical and Electronic	
Emmert, Richard E	U of Iowa	Engineering - Chemical	
Engel, Alexander	N/A	Physics and Astronomy	
English, Thomas S	Iowa State U	Life Sciences - Zoology	
Epstein, Samuel	N/A	Chemistry	
Ernstene, Marshall P	N/A	Physics and Astronomy	
Etter, Daniel O	Texas Christian U	Mathematical Sciences	
Eveleth, Phyllis A	N/A	Life Sciences - Biophysics	
Fairbanks, Frank B	N/A	Engineering - Mechanical	
Fein, Alvin E	N/A	Physics and Astronomy	
Feiner, Frank	Princeton U/NJ	Physics and Astronomy	
Feldman, Jacob	U of Pennsylvania	Mathematical Sciences	
Feldman, Allan M	U of Chicago/IL	Chemistry - Organic	
Felsenfeld, Gary	Harvard U/MA	Chemistry - Physical	
Finger, Irving I	Swarthmore College/PA	Life Sciences - Biology	
Finkel, Leonard	N/A	Engineering - Electrical and Electronic	
Finkelstein, Manuel	U of Scranton/PA	Chemistry - Organic	
Firor, John W	Georgia Institute of Tech	Physics and Astronomy	
Fisher, Allan L	U of Iowa	N/A	
Fishman, Frank J	N/A	Physics and Astronomy	
Fleck, Raymond A	U of Notre Dame/IN	Chemistry - Organic	
Foley, Jean M	Radcliffe College/MA	Life Sciences - Biology	
Ford, George W	U of Michigan	Physics and Astronomy	
Forrester, Herbert A	California Inst of Technology	Mathematical Sciences	
Fort, Arthur W	U of Chicago/IL	Chemistry - Organic	
Foster, Harold M	Lehigh U/PA	Chemistry - Organic	
Fraleigh, John B	N/A	Mathematical Sciences	
Frank, William M	Yeshiva U/NY	Physics and Astronomy - Nuclear	
Franklin, Richard M	Tufts U/MA	Life Sciences - Biophysics	
French, Edwin R	Bowdoin College/ME	N/A	
Fuller, Glenn	Stanford U/CA	Chemistry	
Furth, Harold P	Harvard U/MA	Physics and Astronomy	
Gall, Walter G	Carnegie Mellon U/PA	Chemistry	
Galonsky, Aaron I	CUNY-Brooklyn College	Physics and Astronomy	
Garber, Hirsh N	N/A	Engineering - Electrical and Electronic	
Garrett, Bowman S	Louisiana State U & A&M College	Chemistry - Physical	
Gasser, Robert J	U of Detroit-Mercy/MI	Chemistry - Organic	
Gavis, Jerome	Polytechnic U/NY	Chemistry	
Gay, John H	Cornell U/NY	Mathematical Sciences	
Gealy, Betty L	Southern Methodist U/TX	Geosciences - Geology	
Gelernter, Herbert	CUNY-Brooklyn College	Physics and Astronomy - Nuclear	
Gere, James M	Rensselaer Polytechnic Inst/NY	Engineering - Mechanical	
Ghirardelli, Robert G	N/A	Chemistry - Organic	
Gibbs, Robert H	Cornell U/NY	Life Sciences - Zoology	
Gioumousis, George	Polytechnic U/NY	Chemistry - Organic	
Godfrey, Thomas N	Massachusetts Inst of Technology	Physics and Astronomy	
Godfrey, John C	Pomona College/CA	Chemistry - Organic	
Goebel, Charles J	U of Chicago/IL	Physics and Astronomy	
Gold, Allen M	U of Chicago/IL	Chemistry - Organic	
Goldman, Alan J	N/A	Mathematical Sciences	
Goldman, Peter	N/A	Life Sciences - Biology	
Goldschmidt, Eric N	CUNY-Brooklyn College	Chemistry - Organic	
Goldstein, Lester	CUNY-Brooklyn College	Life Sciences - Zoology	
Gorton, Charles W	Louisiana Tech U	Engineering - Mechanical	
Gould, Roy W	California Inst of Technology	Physics and Astronomy	
Grabowski, Casimer T	Case Western Reserve U/OH	Life Sciences - Biology	
Grace, Edward E	U of North Carolina-Chapel Hill	Mathematical Sciences	
Gram, Andrew L	N/A	N/A	
Granger, Harry C	U of Oregon	Geosciences - Geology	
Gray, Jane	Radcliffe College/MA	Geosciences - Geology	
Gray, Margery P	U of Oregon	N/A	
Greenberg, Oscar W	N/A	Physics and Astronomy	
Greenberg, Harry	N/A	Engineering - Aeronautical and Aerospace	
Greene, Charles M	N/A	Mathematical Sciences	
Gregory, Clarence L	Massachusetts Inst of Technology	Engineering - Chemical	
Griffith, H C	U of Missouri-Columbia	Mathematical Sciences	
Grimm, Phyllis W	N/A	Life Sciences - Botany (including Plant Physiology)	
Griswold, Thomas W	U of California-Berkeley	Physics and Astronomy	
Groesbeck, Marjorie E	N/A	Life Sciences - Botany (including Plant Physiology)	
Gross, Eston M	U of Minnesota-Twin Cities	Chemistry - Organic	
Gross, Leonard	N/A	Physics and Astronomy	
Hadley, Wayne B	Ohio State U	Chemistry	
Hall, Herbert E	U of Kentucky	Life Sciences - Biology	
Hallman, Theodore M	U of Washington	Engineering - Mechanical	
Hamilton, Walter C	Oklahoma State U	Chemistry - Physical	
Hampton, John W	U of California-Berkeley	Chemistry - Organic	
Handschumacher, Robert	Drexel U/PA	N/A	
Hanson, Earl D	Bowdoin College/ME	Life Sciences - Genetics	
Harbourt, Cyrus D	N/A	Engineering	
Hardy, Wilton A	Muhlenberg College/PA	Physics and Astronomy	
Haritatos, Nicholas J	N/A	Engineering - Chemical	
Harlow, Francis H	U of Washington	Physics and Astronomy	
Harris, Frank E	Harvard U/MA	Chemistry	
Hartz, Billy J	N/A	Engineering - Civil	
Hasek, William R	Carnegie Mellon U/PA	Chemistry - Organic	
Hayward, James C	U of Kansas	Engineering - Chemical	
Heald, Mark A	Oberlin College/OH	Physics and Astronomy	
Hecht, Charles E	N/A	Chemistry	
Helfer, Herman L	U of Chicago/IL	Physics and Astronomy - Astronomy	
Helm, Richard H	Stanford U/CA	Physics and Astronomy	
Hendley, Daniel D	Columbia U/NY	N/A	
Hendrick, Roy W	Stanford U/CA	Physics and Astronomy	
Herz, Carl S	Cornell U/NY	Mathematical Sciences	
Herzenberg, Leonard A	N/A	Life Sciences - Biology	
Hess, Robert L	U of California-Berkeley	Engineering - Electrical and Electronic	
Hickmott, Thomas W	Yale University/CT	Chemistry - Physical	
Hilibrand, Jack	CUNY-City College	Engineering - Electrical and Electronic	
Hill, John R	Abilene Christian U/TX	Life Sciences - Physiology	
Hill, David A	Princeton U/NJ	Physics and Astronomy	
Hill, Robert B	N/A	Life Sciences - Biology	
Hill, Jacques A	Massachusetts Inst of Technology	Engineering - Aeronautical and Aerospace	
Hiller, Edwin R	Washington U/MO	Engineering - Electrical and Electronic	
Hoekstra, William G	Colorado State U	N/A	
Hoffmann, Anne	N/A	Life Sciences - Microbiology	
Hoffmann, Robert S	Utah State U	Life Sciences - Zoology	
Holcomb, Donald F	DePauw U/IN	Physics and Astronomy	
Holladay, Wendell	Vanderbilt U/TN	Physics and Astronomy	
Holloway, Joseph H	College of Wooster/OH	Physics and Astronomy	
Holly, Earl D	U of Michigan	Chemistry - Organic	
Holum, John R	Saint Olaf College/MN	Chemistry - Organic	
Honea, Russell M	N/A	Geosciences - Geology	
Honigsberg, Charles A	N/A	Engineering - Mechanical	
Hooke, William M	N/A	Physics and Astronomy	
Horelick, Brindell	N/A	Mathematical Sciences	
Horowicz, Paul	New York U	Life Sciences - Biophysics	
Horowitz, Jack	N/A	N/A	
Horowitz, Lawrence P	N/A	Physics and Astronomy	
Horwitz, Nahmin	Case Western Reserve U/OH	Physics and Astronomy	
Howard, Louis N	Swarthmore College/PA	Physics and Astronomy	
Howell, Francis C	U of Chicago/IL	N/A	
Hull, Joseph P	N/A	Geosciences - Geology	
Humphreys, Thomas E	Ohio State U	Life Sciences - Botany (including Plant Physiology)	
Hunt, William W	N/A	Chemistry - Physical	
Hurst, Vernon J	U of Georgia	Geosciences - Geology	
Ibers, James A	California Inst of Technology	Chemistry - Inorganic	
Irwin, Richard L	Johns Hopkins U/MD	Chemistry - Physical	
Jacob, Charles E	U of Utah	Geosciences - Geology	
Jaross, Robert W	N/A	Chemistry	
Johnson, Benjamin M	N/A	Engineering - Chemical	
Jolly, Eugene R	U of Wisconsin-Madison	N/A	
Jones, Robert E	N/A	Engineering - Civil	
Jones, Quentin	Washington State U	Life Sciences - Biology	
Juhle, Rolf W	Johns Hopkins U/MD	Geosciences - Geology	
Kahn, Arnold H	Rensselaer Polytechnic Inst/NY	Physics and Astronomy	
Kant, Fred H	Columbia U/NY	Engineering - Chemical	
Kasner, William H	Case Western Reserve U/OH	Physics and Astronomy	
Kaufman, Charles J	N/A	Mathematical Sciences - Algebra or Number Theory	
Kavanaugh, Ralph W	Reed College/OR	Physics and Astronomy	
Kelleher, Therese M	N/A	Life Sciences - Biology	
Kemp, Nelson H	Ohio State U	Engineering - Aeronautical and Aerospace	
Kendall, Robert M	N/A	Engineering - Chemical	
Ketcham, Roger G	Antioch U/OH	Chemistry - Physical	
Kice, John L	Harvard U/MA	Chemistry	
Klemperer, William A	Harvard U/MA	Chemistry	
Knight, Bruce W	N/A	Physics and Astronomy	
Koeppe, Owen J	Hope College/MI	N/A	
Kofron, James T	N/A	Chemistry - Organic	
Kohler, Donald A	U of Oregon	Physics and Astronomy	
Kohn, Robert R	U of Wisconsin-Madison	Life Sciences - Physiology	
Kohout, Patricia M	N/A	Chemistry - Physical	
Kopple, Kenneth D	Massachusetts Inst of Technology	Chemistry - Organic	
Kostant, Bertram	Purdue U/IN	Mathematical Sciences	
Kraintz, Leon	Harvard U/MA	Life Sciences - Physiology	
Kramer, Arnold G	N/A	Physics and Astronomy	
Kranzer, Herbert C	N/A	Mathematical Sciences	
Kraut, Joseph	Bucknell U/PA	Chemistry	
Krebs, Robert D	N/A	Life Sciences - Biology	
Krieger, Theodore J	CUNY-City College	Physics and Astronomy - Theoretical Physics	
Krone, Lester H	N/A	Engineering - Chemical	
Kuller, Robert G	Swarthmore College/PA	Mathematical Sciences	
Kulsrud, Russell M	U of Maryland-College Park	Physics and Astronomy	
Laberge, Wallace E	U of North Dakota	Life Sciences - Entomology	
Lacey, Richard F	N/A	Physics and Astronomy	
Laing, Charles C	U of Chicago/IL	Life Sciences - Botany (including Plant Physiology)	
Lakin, Wilbur	Union College/NY	Physics and Astronomy	
Lambert, Francis L	George Washington U/DC	Life Sciences - Biology	
Lands, William E	U of Michigan	N/A	
Lang, Lawrence G	N/A	Physics and Astronomy	
Lasalle, Michael W	Washington U/MO	Life Sciences - Physiology	
Lazaroff, Norman	Syracuse U/NY	Life Sciences - Biology	
Lazarus, John P	N/A	Physics and Astronomy	
Lednicer, Daniel	N/A	Chemistry - Organic	
Lehman, Russell S	Stanford U/CA	Mathematical Sciences	
Lemish, John	U of Michigan	Geosciences - Geology	
Leppert, George	U of Wisconsin-Madison	Engineering - Mechanical	
Lesnick, Marie	Mount Holyoke College/MA	Mathematical Sciences	
Lesure, Frank G	VA Polytech Inst & State U	Geosciences - Geology	
Levine, Samuel G	Tufts U/MA	Chemistry - Organic	
Levinson, Carl A	Swarthmore College/PA	Physics and Astronomy	
Levy, Milton	N/A	Physics and Astronomy	
Lewis, Robert R	U of Michigan	Physics and Astronomy	
Lewontin, Richard C	Harvard U/MA	Life Sciences - Zoology	
Lichtman, Leo	N/A	Engineering - Mechanical	
Limber, David N	Ohio State U	Physics and Astronomy - Astronomy	
Lindeberg, George K	N/A	Physics and Astronomy	
Linder, Solomon L	Rutgers State U-New Brunswick/NJ	Physics and Astronomy	
Lipps, Frederick W	Johns Hopkins U/MD	Physics and Astronomy	
Liss, Theodor A	N/A	Chemistry - Organic	
Lockhart, James A	Michigan State U	Life Sciences - Physiology	
Loewenberg, Jakob R	Harvard U/MA	Life Sciences - Botany (including Plant Physiology)	
Long, Miner B	Oberlin College/OH	Geosciences - Geology	
Lovejoy, Elwyn R	Boston U/MA	Chemistry	
Lubitz, Cecil R	United States Naval Academy/MD	Physics and Astronomy	
Ludlum, David B	Cornell U/NY	Chemistry - Physical	
Lundelius, Ernest L	U of Texas-Austin	Geosciences - Geology	
Lurie, Robert M	N/A	Engineering - Chemical	
Mackin, Robert J	Yale University/CT	Physics and Astronomy	
Magee, Wayne E	Kalamazoo College/MI	N/A	
Magee, Charles B	U of Detroit-Mercy/MI	Chemistry	
Mallett, Gordon E	Purdue U/IN	Life Sciences - Microbiology	
Marinetti, Guido V	U of Rochester/NY	N/A	
Martin, Paul S	Cornell U/NY	Life Sciences - Zoology	
Martin, Paul C	Harvard U/MA	Physics and Astronomy	
Mason, Lawrence H	Wesleyan University/CT	N/A	
Mathews, Jon	Pomona College/CA	Physics and Astronomy	
Mattuck, Arthur P	Swarthmore College/PA	Mathematical Sciences	
Mauzerall, David C	St Michael's College/VT	Chemistry - Physical	
Mayberry, John P	University of Toronto/Canada	Mathematical Sciences	
Mazo, Robert M	N/A	Chemistry - Physical	
Mccall, David W	Wichita State U/KS	Chemistry	
Mccay, Paul B	U of Oklahoma	Life Sciences - Physiology	
Mcclure, Joel W	Northwestern U/IL	Physics and Astronomy	
Mcdonald, Barbara B	Simmons College/MA	Life Sciences - Zoology	
Mcgervey, John D	N/A	Physics and Astronomy	
Mcisaac, Paul R	Cornell U/NY	Engineering - Electrical and Electronic	
Mckisson, Earl W	U of Florida	Chemistry	
Mclaughlin, James P	Merrimack College/MA	Life Sciences - Biology	
Mcleish, William L	U of Illinois-Urbana-Champaign	Chemistry - Organic	
Meeker, Thrygve R	Ursinus College/PA	Chemistry - Physical	
Meinhart, Margaret O	Vassar College/NY	N/A	
Merrill, Stewart H	Case Western Reserve U/OH	Chemistry	
Merten, Ulrich	California Inst of Technology	Chemistry - Inorganic	
Metter, Raymond E	Eastern Illinois U	Geosciences - Geology	
Metzenberg, Robert L	Pomona College/CA	N/A	
Meyer, Jeanpierre G	Cornell U/NY	Mathematical Sciences	
Meyer, Robert E	U of Chicago/IL	Chemistry - Physical	
Milburn, Richard H	Harvard U/MA	Physics and Astronomy	
Miller, Stanley L	U of California-Berkeley	Chemistry - Physical	
Miller, Robert M	N/A	Chemistry - Physical	
Miller, David H	U of California-Los Angeles	Geosciences - Geology	
Mills, Robert L	Columbia U/NY	Physics and Astronomy	
Milnor, John W	Princeton U/NJ	Mathematical Sciences	
Mizel, Victor J	N/A	Mathematical Sciences	
Moldenhauer, Marjorie G	N/A	N/A	
Moore, John F	Massachusetts Inst of Technology	Physics and Astronomy	
Moore, William R	U of California-Los Angeles	Chemistry - Organic	
Morgan, Thomas N	Oberlin College/OH	Physics and Astronomy	
Morley, Michael D	Case Western Reserve U/OH	Mathematical Sciences	
Morrow, Leroy W	N/A	N/A	
Morton, Harold S	U of Minnesota-Twin Cities	Physics and Astronomy	
Moyed, Harris S	Widener U/PA	Life Sciences - Botany (including Plant Physiology)	
Moynihan, Robert E	Canisius College/NY	Chemistry - Physical	
Moynihan, Martin H	Princeton U/NJ	Life Sciences - Zoology	
Mueller, Wheeler K	Iowa State U	Engineering - Mechanical	
Muhs, Merrill A	U of California-Berkeley	Chemistry	
Munkres, James R	Nebraska Wesleyan U	Mathematical Sciences	
Murray, George R	N/A	Physics and Astronomy	
Neal, Arthur H	Birmingham-Southern College/AL	Chemistry - Physical	
Neimark, Joshua E	N/A	Engineering - Mechanical	
Nelson, Joseph E	U of Chicago/IL	Mathematical Sciences	
Nesbet, Robert K	Harvard U/MA	Chemistry	
Newman, Donald J	New York U	Mathematical Sciences	
Niestlie, John W	North Carolina Central U	Physics and Astronomy - Nuclear	
Nixon, Walter B	Yale University/CT	Engineering - Aeronautical and Aerospace	
Nodvik, John S	N/A	Physics and Astronomy	
Norstog, Knut J	Luther College/IA	Life Sciences - Botany (including Plant Physiology)	
Offenbach, Jack A	New York U	Chemistry - Physical	
Oldfield, Abby B	N/A	Psychology	
Oliphant, Thomas A	Louisiana State U & A&M College	Physics and Astronomy	
Olson, John M	Wesleyan University/CT	Life Sciences - Biophysics	
Pahl, Herbert B	Swarthmore College/PA	N/A	
Palais, Richard S	Harvard U/MA	Mathematical Sciences	
Palmer, Edward P	N/A	Physics and Astronomy	
Pardo, John F	Columbia U/NY	Engineering - Chemical	
Parshall, George W	U of Minnesota-Twin Cities	Chemistry - Organic	
Parsons, Theran D	U of Washington	Chemistry	
Parzen, Emanuel	Harvard U/MA	Mathematical Sciences	
Peck, Harry D Jr	Wesleyan University/CT	Life Sciences - Microbiology	
Perry, Armin R	SUNY-Buffalo	Life Sciences - Biophysics	
Peterson, Franklin P	Northwestern U/IL	Mathematical Sciences - Algebra or Number Theory	
Petitjean, Donald L	U of Wisconsin-Madison	Chemistry - Analytical	
Petree, Harris E	U of Illinois-Urbana-Champaign	Chemistry - Organic	
Pettus, David	Arizona State U	Life Sciences - Zoology	
Phister, Montgomery	Stanford U/CA	Engineering	
Plock, Richard J	N/A	Chemistry - Physical	
Poindexter, Edward H	N/A	Geosciences - Geology	
Pollak, Barth	Illinois Inst of Tech	Mathematical Sciences	
Powers, Harry R	U of North Carolina-Chapel Hill	N/A	
Pratt, John W	N/A	Mathematical Sciences - Probability and Statistics	
Prenzlow, Carl F	U of Colorado	Chemistry - Organic	
Priest, Richard E	U of Illinois-Urbana-Champaign	Mathematical Sciences	
Pugh, Alexander L	N/A	Engineering - Electrical and Electronic	
Punnett, Hope H	Smith College/MA	Life Sciences - Botany (including Plant Physiology)	
Putnam, Robert E	U of Massachusetts-Amherst	Chemistry - Organic	
Pycha, Richard L	N/A	Life Sciences - Entomology	
Reed, John C	Johns Hopkins U/MD	Geosciences - Geology	
Reese, Lymon C	U of Texas-Austin	Engineering - Civil	
Rempel, Robert C	Pomona College/CA	Physics and Astronomy	
Rentsch, Helen J	N/A	Physics and Astronomy - Theoretical Physics	
Rice, Stuart A	N/A	Chemistry - Physical	
Rice, Melvin H	N/A	Physics and Astronomy	
Richardson, Lee S	Massachusetts Inst of Technology	Engineering - Metallurgical	
Richardson, James W	N/A	Chemistry - Physical	
Richardson, Dewayne L	Ripon College/WI	Life Sciences - Botany (including Plant Physiology)	
Richter, Burton	N/A	Physics and Astronomy	
Riesenfeld, Werner B	California Inst of Technology	Physics and Astronomy	
Rinehart, Kenneth L	Yale University/CT	Chemistry - Organic	
Rodenberg, Sidney D	Washington U/MO	Life Sciences - Botany (including Plant Physiology)	
Romer, Robert H	N/A	Physics and Astronomy	
Rosen, Walter G	U of Iowa	Life Sciences - Botany (including Plant Physiology)	
Rosenfeld, Arthur H	VA Polytech Inst & State U	Physics and Astronomy	
Roth, Willard D	Swarthmore College/PA	Life Sciences - Biology	
Roth, Laura M	N/A	Physics and Astronomy	
Rouleau, Wilfred T	Carnegie Mellon U/PA	Engineering - Mechanical	
Rubenstein, Richard A	Ohio State U	Physics and Astronomy	
Ruby, Philip R	U of Illinois-Urbana-Champaign	Chemistry	
Ruck, Philip R	Unknown	Life Sciences - Zoology	
Rumely, John H	Oberlin College/OH	Life Sciences - Botany (including Plant Physiology)	
Salsburg, Zevi W	U of Rochester/NY	Chemistry	
Sansoucie, Robert L	U of Massachusetts-Amherst	Mathematical Sciences	
Sartori, Leo	Massachusetts Inst of Technology	Physics and Astronomy	
Sax, Sylvan M	U of Pittsburgh/PA	Chemistry	
Scarf, Herbert	Temple U/PA	Mathematical Sciences	
Schaad, Lawrence J	N/A	Chemistry - Organic	
Schapiro, Miriam	Columbia U/NY	Mathematical Sciences	
Schmidt, Paul W	Carleton College/MN	Physics and Astronomy	
Schwaar, Robert H	N/A	Engineering - Chemical	
Schwartz, Charles L	N/A	Physics and Astronomy	
Scott, Thomas A	N/A	Physics and Astronomy - Astronomy	
Scotten, Harold L	Indiana U-Bloomington	Life Sciences - Biology	
Sedgwick, Thomas A	N/A	Engineering - Mechanical	
Selander, Richard B	U of Utah	Life Sciences - Entomology	
Selander, Robert K	U of Utah	Life Sciences - Zoology	
Selig, Henry H	U of Chicago/IL	Chemistry	
Seligman, George B	U of Rochester/NY	Mathematical Sciences	
Senger, Clyde M	Reed College/OR	Life Sciences - Biology	
Sessler, Andrew M	Harvard U/MA	Physics and Astronomy	
Shaffer, Robert L	Kansas State U/KS	Life Sciences - Botany (including Plant Physiology)	
Shapiro, Jacob	CUNY-City College	Life Sciences - Biophysics	
Shapiro, Norman	N/A	Mathematical Sciences	
Sher, Irving H	U of Pennsylvania	N/A	
Shlichta, Paul J	N/A	Chemistry - Organic	
Silas, Robert S	U of Florida	Chemistry - Physical	
Simeral, William G	Franklin and Marshall College/PA	Physics and Astronomy	
Singer, Maxine F	Swarthmore College/PA	N/A	
Sistrom, William R	Harvard U/MA	Life Sciences - Microbiology	
Skallerup, Marilyn G	Chatham College/PA	Life Sciences - Botany (including Plant Physiology)	
Slonczewski, John C	Worcester Polytechnic Inst/MA	Physics and Astronomy	
Sly, William G	San Diego State U/CA	Chemistry - Physical	
Smith, James R	Brigham Young U/UT	Physics and Astronomy	
Smith, Buford D	Oklahoma State U	Engineering - Chemical	
Smith, Henry J	Harvard U/MA	Physics and Astronomy - Astronomy	
Smith, Carl W	N/A	Chemistry - Analytical	
Sonneborn, Lee M	Oberlin College/OH	Mathematical Sciences	
Spanier, Jerome	U of Minnesota-Twin Cities	Mathematical Sciences - Algebra or Number Theory	
Speer, Donald A	U of Chicago/IL	Chemistry - Organic	
Sperry, Robert V	N/A	Engineering - Electrical and Electronic	
Stadler, Henry L	Harvard U/MA	Physics and Astronomy	
Stehle, Peter F	Loyola College/MD	Chemistry - Physical	
Stehli, Francis G	St Lawrence U/NY	Geosciences - Geology	
Steidel, Robert F	Columbia U/NY	Engineering - Mechanical	
Stein, Stanley	Temple U/PA	Physics and Astronomy	
Stein, Peter C	N/A	Physics and Astronomy	
Stengle, Thomas R	Franklin and Marshall College/PA	Chemistry - Physical	
Stephens, George R	N/A	N/A	
Stern, Frank	Union College/NY	Physics and Astronomy	
Stewart, John C	U of the South/TN	Physics and Astronomy	
Stiles, Rufus M	Ohio State U	Chemistry	
Strother, John A	Trinity College/CT	Engineering - Electrical and Electronic	
Strull, Gene	Purdue U/IN	Engineering - Electrical and Electronic	
Struve, Donald L	N/A	Chemistry - Physical	
Sucher, Joseph	N/A	Physics and Astronomy	
Sutherland, George S	U of Michigan	Engineering - Aeronautical and Aerospace	
Sutton, George W	N/A	Engineering - Mechanical	
Sutton, Granger G	N/A	Geosciences - Geology	
Swanson, Robert A	Illinois Inst of Tech	Physics and Astronomy	
Sweet, Walter C	Colorado College	Geosciences - Geology	
Swihart, Thomas L	Indiana U-Bloomington	Physics and Astronomy - Astronomy	
Tadanier, John S	N/A	Chemistry - Physical	
Taub, Arthur	N/A	Life Sciences - Biophysics	
Tauber, Stephen J	N/A	Chemistry - Organic	
Teager, Herbert M	N/A	Engineering - Electrical and Electronic	
Teeters, Robert D	Oberlin College/OH	Engineering	
Teitelbaum, Philip	CUNY-City College	Psychology	
Tessman, Ethel S	Bryn Mawr College/PA	Life Sciences - Biophysics	
Tessman, Irwin	Cornell U/NY	Physics and Astronomy	
Thimann, Vivianne	N/A	Life Sciences - Physiology	
Thomas, Richard C	Oregon State U	Chemistry	
Thornton, Charles P	U of Virginia-Charlottesville	Geosciences - Geology	
Tichacek, Louis J	N/A	Engineering - Chemical	
Tobocman, William	Massachusetts Inst of Technology	Physics and Astronomy	
Toman, Robert J	U of Minnesota-Twin Cities	Engineering - Chemical	
Toxen, Arnold M	N/A	Physics and Astronomy - Nuclear	
Tremaine, Mary M	U of Wyoming	Life Sciences - Microbiology	
Trilling, George H	California Inst of Technology	Physics and Astronomy	
Troyer, James R	DePauw U/IN	Life Sciences - Biology	
Turyn, Richard J	Harvard U/MA	Mathematical Sciences	
Ullman, Edwin F	N/A	Chemistry - Organic	
Ulrich, Werner	N/A	Engineering - Electrical and Electronic	
Upchurch, Robert P	U of North Carolina-Chapel Hill	Life Sciences - Physiology	
Vanlaer, Helen R	N/A	Geosciences - Geology	
Vanlint, Victor A	California Inst of Technology	Physics and Astronomy	
Vanschaik, Nancy W	Eastern Illinois U	Life Sciences - Genetics	
Vaughn, Peter P	CUNY-Brooklyn College	Life Sciences - Biology	
Vonhippel, Peter H	N/A	Life Sciences - Biology	
Walsh, Patrick N	Fordham U/NY	Chemistry - Physical	
Walter, John K	N/A	Engineering - Civil	
Warters, William D	Harvard U/MA	Physics and Astronomy	
Warters, Mary E	Oberlin College/OH	Life Sciences - Entomology	
Waters, Thomas F	N/A	Life Sciences - Zoology	
Wayner, Matthew J	Dartmouth College/NH	Psychology	
Weaver, Joseph M	N/A	Physics and Astronomy	
Weaver, Andrew A	College of Wooster/OH	Life Sciences - Zoology	
Weeks, Wilford F	U of Illinois-Urbana-Champaign	Geosciences - Geology	
Weikel, John H	Trinity College/CT	N/A	
Weil, Edward D	U of Pennsylvania	Chemistry - Organic	
Weinberg, Roger	Tulane U/LA	Life Sciences - Genetics	
Welch, Jasper A	N/A	Physics and Astronomy	
Weller, Harry	U of Pennsylvania	Life Sciences - Physiology	
Wempner, Gerald A	N/A	Engineering - Mechanical	
Wennstrom, Arthur E	California Inst of Technology	Engineering - Electrical and Electronic	
West, Robert C	Cornell U/NY	Chemistry	
Westley, John L	U of Chicago/IL	N/A	
Wetlaufer, Donald B	U of Wisconsin-Madison	N/A	
White, David A	Dartmouth College/NH	Geosciences - Geology	
Whitesitt, John E	U of Montana	Mathematical Sciences	
Wich, Grosvenor S	U of Rochester/NY	Chemistry	
Widom, Harold	U of Chicago/IL	Mathematical Sciences	
Wilcox, Charles F	N/A	Chemistry - Organic	
Wilcox, Calvin H	Harvard U/MA	Mathematical Sciences	
Wilhoit, James C	Rice U/TX	Engineering - Mechanical	
Williams, George A	N/A	Chemistry - Physical	
Wilson, David J	N/A	Chemistry - Physical	
Wilson, Victor J	Tufts U/MA	Life Sciences - Physiology	
Wilson, Edward O	U of Alabama	Life Sciences - Entomology	
Wilt, James W	U of Chicago/IL	Chemistry - Organic	
Winchester, John W	U of Chicago/IL	Chemistry - Physical	
Winslow, Charles E	VA Polytech Inst & State U	Engineering - Chemical	
Wissbrun, Kurt F	N/A	Chemistry - Physical	
Wittreich, Warren J	Princeton U/NJ	Psychology	
Wolcott, Arthur R	Michigan State U	N/A	
Wolfe, Bertram	Princeton U/NJ	Physics and Astronomy	
Wolff, Sheldon	Tufts U/MA	Life Sciences - Biology	
Wolff, Edith C	Smith College/MA	N/A	
Wolff, Barbara C	Swarthmore College/PA	Life Sciences - Biology	
Wood, Thomas H	U of Florida	Life Sciences - Biophysics	
Woodin, Howard E	Union College/NY	Life Sciences - Biology	
Wright, William V	California Inst of Technology	Engineering - Mechanical	
Wycoff, Robert E	N/A	Engineering - Mechanical	
Wyse, Frank O	N/A	Mathematical Sciences	
Yarmolinsky, Michael B	Harvard U/MA	N/A	
Yudelson, Joseph S	U of Pittsburgh/PA	Chemistry	
Zachariasen, Fredrik	U of Chicago/IL	Physics and Astronomy	
Zajac, Edward E	Cornell U/NY	Engineering - Mechanical	
Zemlin, Richard A	U of Saint Thomas/MN	Mathematical Sciences	
Zimmerman, William J	N/A	Physics and Astronomy	
Zoellner, William G	N/A	Chemistry - Organic	
Zwick, Stanley A	California Inst of Technology	Physics and Astronomy	
